RRRRRRRRRRRRRRRR
BBBBBBBBBBBBBBBB
RRRRRRRRRRRRRRRR
0000000000000000
U0102030T0t0S0G0
0000000000000000
0000000000000000