RRRRRRRRBBBBBBBB
RRRRRRRRBBBBBBBB
RRRRRRRRBBBBBBBB
RRRRRRRRBBBBBBBB
RRRRRRRRBBBBBBBB
0000000000000000
0000000000000000
0000000S00000000