0000000000000000
0011111111111100
0012222222222100
0012333333332100
0012222222222100
0011111111111100
00UUUUUUUUUUUU00